Reserved words
    We have 64 reserved words in javascript, below are those.
    abstract	arguments	await*	        boolean
    break	    byte	    case	        catch
    char	    class*	    const	        continue
    debugger	default	    delete	        do
    double	    else	    enum*	        eval
    export*	    extends*	false	        final
    finally	    float	    for	            function
    goto	    if	        implements	    import*
    in	        instanceof	int	            interface
    let*	    long	    native	        new
    null	    package	    private	        protected
    public	    return	    short	        static
    super*	    switch	    synchronized	this
    throw	    throws	    transient	    true
    try	        typeof	    var	            void
    volatile	while	    with	        yield
We cannot use these reserved words as variables, labels, or function names.
Words marked with* are new in ECMAScript 5 and 6.
==
Removed Reserved Words
The following reserved words have been removed from the ECMAScript 5/6 standard
    abstract	    boolean	    byte	        char
    double	        final	    float	        goto
    int	            long	    native	        short
    synchronized	throws	    transient	    volatile
